-99f.........
-99n.........
-99a.........
-99r.........
-99j.........
-99I.........
-99J.........
-99K.........
-99L.........
-00b.........
-99M.........
-99N.........
-99O.........
-99P.........
-00b.........
-99A.........
-99B.........
-99C.........
-99D.........
-00b.........
-99E.........
-99F.........
-99G.........
-99H.........
-00b.........
-99w.........
-99x.........
-99y.........
-99z.........
-00b.........
-99Q.........
-99R.........
-99S.........
-99Z.........
-02T.........
*
